raw_voters,reg,tik,valid_ballots,invalid_ballots,population,population_group,sum,sum_city,population_density
385,Алтайский край,Алтайская,174,4,37078,4,178,3529,0.05
988,Алтайский край,Бийская,377,15,26480,4,392,3529,0.11
1044,Алтайский край,Смоленская,432,11,19181,4,443,3529,0.13
81,Алтайский край,Чарышская,37,0,9141,4,37,3529,0.01
404,Алтайский край,Егорьевская,168,1,9937,4,169,3529,0.05
719,Алтайский край,Рубцовская,346,15,17255,4,361,3529,0.1
1244,Алтайский край,"Бийск, Восточная",464,17,77682,5,481,3529,0.14
1694,Алтайский край,Заринская городская,651,22,34910,4,673,3529,0.19
175,Алтайский край,Тогульская,102,0,6179,4,102,3529,0.03
1098,Алтайский край,Благовещенская,325,14,58251,5,339,3529,0.1
743,Алтайский край,Михайловская,289,12,59591,5,301,3529,0.09
83,Алтайский край,Тюменцевская,53,0,10065,4,53,3529,0.02
1755,Амурская область,ЗАТО Циолковский,926,72,3686,3,998,2216,0.45
256,Амурская область,Михайловского района,146,2,10317,4,148,2216,0.07
1187,Амурская область,Сковородинского района,347,6,20189,4,353,2216,0.16
2244,Амурская область,города Благовещенск,702,15,167513,6,717,2216,0.32
2478,Архангельская область,"Архангельск, Октябрьская",1096,20,63823,5,1116,2024,0.55
958,Архангельская область,Коношская,286,5,17976,4,291,2024,0.14
140,Архангельская область,Северодвинская городская № 1,113,6,72838,5,119,2024,0.06
13,Архангельская область,"Архангельск, Южная",13,0,59932,5,13,2024,0.01
608,Архангельская область,Красноборская,252,4,10866,4,256,2024,0.13
556,Архангельская область,Приморская_73,225,4,15380,4,229,2024,0.11
2168,Астраханская область,"Астрахань, Кировская",577,8,84512,5,585,2043,0.29
423,Астраханская область,Ахтубинская,154,4,49557,4,158,2043,0.08
1844,Астраханская область,Камызякская,919,24,34261,4,943,2043,0.46
794,Астраханская область,Приволжская,345,12,74558,5,357,2043,0.17
1345,Белгородская область,Белгородская городская,522,13,287727,6,535,4205,0.13
1506,Белгородская область,Белгородская районная,704,15,128195,5,719,4205,0.17
851,Белгородская область,Краснояружская,667,5,11536,4,672,4205,0.16
176,Белгородская область,Алексеевская,162,0,87972,5,162,4205,0.04
1241,Белгородская область,Губкинская,564,14,81442,5,578,4205,0.14
617,Белгородская область,Красногвардейская,435,5,155017,6,440,4205,0.1
2362,Белгородская область,Старооскольская,942,16,207090,6,958,4205,0.23
207,Белгородская область,Шебекинская,137,4,69611,5,141,4205,0.03
372,Брянская область,Выгоничская,355,0,13766,4,355,3728,0.1
1454,Брянская область,Новозыбковская городская,768,22,39763,4,790,3728,0.21
265,Брянская область,Стародубская,257,0,28226,4,257,3728,0.07
1967,Брянская область,"Брянск, Бежицкая",1560,16,120783,5,1576,3728,0.42
699,Брянская область,Жирятинская,572,9,4816,3,581,3728,0.16
207,Брянская область,Мглинская,168,1,12781,4,169,3728,0.05
1375,Владимирская область,"Владимир, Октябрьская",514,4,85554,5,518,2394,0.22
1076,Владимирская область,Гусь-Хрустальная городская,366,8,50924,5,374,2394,0.16
422,Владимирская область,Меленковская,253,5,26382,4,258,2394,0.11
1047,Владимирская область,Александровская,411,17,159385,6,428,2394,0.18
659,Владимирская область,Киржачская,290,15,32522,4,305,2394,0.13
1603,Владимирская область,Собинская,498,13,44626,4,511,2394,0.21
2946,Волгоградская область,"Волгоград, Краснооктябрьская",1519,140,110779,5,1659,7876,0.21
1732,Волгоградская область,Жирновская,1242,8,29538,4,1250,7876,0.16
202,Волгоградская область,Руднянская,120,0,29099,4,120,7876,0.02
241,Волгоградская область,Калачевская,199,0,43910,4,199,7876,0.03
1755,Волгоградская область,Светлоярская,1066,9,28938,4,1075,7876,0.14
2178,Волгоградская область,"Волгоград, Дзержинская",1695,0,132699,5,1695,7876,0.22
868,Волгоградская область,Нехаевская,717,5,10791,4,722,7876,0.09
756,Волгоградская область,Быковская,513,9,18677,4,522,7876,0.07
1364,Волгоградская область,Ленинская,622,12,245986,6,634,7876,0.08
234,Вологодская область,Бабушкинская,115,1,9631,4,116,2330,0.05
1157,Вологодская область,Вологодская городская,483,7,250385,6,490,2330,0.21
238,Вологодская область,Кичменгско-Городецкая,155,2,13120,4,157,2330,0.07
192,Вологодская область,Тотемская,121,3,17332,4,124,2330,0.05
170,Вологодская область,Кадуйская,83,0,13630,4,83,2330,0.04
2879,Вологодская область,Череповецкая городская,1344,16,242671,6,1360,2330,0.58
1640,Воронежская область,"Воронеж, Железнодорожная",496,6,116057,5,502,5396,0.09
807,Воронежская область,"Воронеж, Центральная",779,28,85901,5,807,5396,0.15
210,Воронежская область,Новоусманская,206,0,65886,5,206,5396,0.04
2042,Воронежская область,"Воронеж, Советская",641,17,161914,6,658,5396,0.12
1186,Воронежская область,Репьевская,1043,0,12566,4,1043,5396,0.19
184,Воронежская область,Верхнехавская,147,4,18173,4,151,5396,0.03
1438,Воронежская область,Грибановская,938,24,23887,4,962,5396,0.18
836,Воронежская область,Эртильская,541,15,18704,4,556,5396,0.1
25,Воронежская область,Бутурлиновская,25,0,37531,4,25,5396,0.0
328,Воронежская область,Новохоперская,319,0,27636,4,319,5396,0.06
174,Воронежская область,Подгоренская,167,0,18246,4,167,5396,0.03
1128,Еврейская автономная область,Биробиджанская городская,332,15,57979,5,347,347,1.0
243,Забайкальский край,Александрово-Заводская,148,2,5862,4,150,2721,0.06
183,Забайкальский край,Нерчинско-Заводская,68,0,7003,4,68,2721,0.02
2266,Забайкальский край,"Чита, Ингодинская",789,11,52847,5,800,2721,0.29
2035,Забайкальский край,Агинская городская,843,25,12175,4,868,2721,0.32
1335,Забайкальский край,Кыринская,438,18,9975,4,456,2721,0.17
1418,Забайкальский край,Хилокская,372,7,20771,4,379,2721,0.14
1387,Ивановская область,"Иваново, Октябрьская",364,8,67552,5,372,1696,0.22
866,Ивановская область,Кохомская городская,246,10,24096,4,256,1696,0.15
1140,Ивановская область,Шуйская городская,441,6,43301,4,447,1696,0.26
1339,Ивановская область,"Иваново, Советская",410,6,47844,4,416,1696,0.25
439,Ивановская область,Родниковская,204,1,31694,4,205,1696,0.12
1042,Иркутская область,Зиминская городская,503,18,22870,4,521,4046,0.13
2496,Иркутская область,Иркутская - 93,701,26,55056,5,727,4046,0.18
162,Иркутская область,Осинская,87,0,38113,4,87,4046,0.02
105,Иркутская область,Аларская,55,0,17879,4,55,4046,0.01
193,Иркутская область,Боханская,119,0,17615,4,119,4046,0.03
456,Иркутская область,Нукутская,258,7,11367,4,265,4046,0.07
1505,Иркутская область,"Иркутск, Иркутская городская № 4",503,16,151178,6,519,4046,0.13
486,Иркутская область,Тайшетская,222,5,55606,5,227,4046,0.06
1230,Иркутская область,Усольская,378,8,35763,4,386,4046,0.1
111,Иркутская область,Бодайбинская,104,2,15741,4,106,4046,0.03
1409,Иркутская область,Братская городская,472,15,165865,6,487,4046,0.12
1523,Иркутская область,Усть-Илимская городская,524,23,60439,5,547,4046,0.14
802,Кабардино-Балкарская Республика,Лескенская,671,1,17890,4,672,1946,0.35
1407,Кабардино-Балкарская Республика,Прохладненская городская,1274,0,36133,4,1274,1946,0.65
3153,Калининградская область,Гурьевская 97,1955,42,56576,5,1997,3356,0.6
761,Калининградская область,Пионерская,286,6,10755,4,292,3356,0.09
2300,Калининградская область,"Калининград, Московская",844,33,139366,5,877,3356,0.26
375,Калининградская область,Озерская,183,7,10267,4,190,3356,0.06
2482,Калужская область,"Калуга, Ленинская",927,15,117497,5,942,2757,0.34
2452,Калужская область,Обнинская городская,1010,16,90887,5,1026,2757,0.37
1518,Калужская область,Боровская,637,17,47647,4,654,2757,0.24
550,Калужская область,"Калуга, Октябрьская",134,1,80873,5,135,2757,0.05
1104,Камчатский край,Вилючинская,544,22,15812,4,566,586,0.97
20,Камчатский край,Петропавловск-Камчатская (судовая),20,0,6720,4,20,586,0.03
884,Карачаево-Черкесская Республика,Зеленчукская,802,6,35629,4,808,1636,0.49
951,Карачаево-Черкесская Республика,Хабезская,814,14,18565,4,828,1636,0.51
146,Кемеровская область - Кузбасс,Ижморская,126,4,9469,4,130,8450,0.02
81,Кемеровская область - Кузбасс,Мариинская,58,2,36816,4,60,8450,0.01
1411,Кемеровская область - Кузбасс,Юргинская городская,1105,17,59553,5,1122,8450,0.13
1105,Кемеровская область - Кузбасс,Киселевская городская,934,18,70147,5,952,8450,0.11
402,Кемеровская область - Кузбасс,Новокузнецкая,311,8,34600,4,319,8450,0.04
70,Кемеровская область - Кузбасс,Прокопьевская,61,2,21354,4,63,8450,0.01
2111,Кемеровская область - Кузбасс,"Кемерово, Заводская",1500,30,107506,5,1530,8450,0.18
1329,Кемеровская область - Кузбасс,Полысаевская городская,1004,13,21581,4,1017,8450,0.12
1378,Кемеровская область - Кузбасс,Калтанская городская,1033,39,22662,4,1072,8450,0.13
3679,Кемеровская область - Кузбасс,"Новокузнецк, Центральная",2127,58,124019,5,2185,8450,0.26
122,Кировская область,Афанасьевская,89,1,9969,4,90,3500,0.03
1894,Кировская область,"Киров, Октябрьская 2",831,23,61943,5,854,3500,0.24
966,Кировская область,Омутнинская,438,15,30044,4,453,3500,0.13
2325,Кировская область,Слободская городская,874,30,25768,4,904,3500,0.26
199,Кировская область,Кильмезская,133,3,9888,4,136,3500,0.04
1014,Кировская область,Кирово-Чепецкая,493,14,18823,4,507,3500,0.14
639,Кировская область,Санчурская,380,5,7015,4,385,3500,0.11
262,Кировская область,Яранская,170,1,20260,4,171,3500,0.05
502,Костромская область,Костромская,169,4,34652,4,173,1252,0.14
267,Костромская область,Макарьевская,161,1,11328,4,162,1252,0.13
2431,Костромская область,Солигаличская,897,20,7634,4,917,1252,0.73
2743,Краснодарский край,"Краснодар, Западная",1089,18,141080,5,1107,18448,0.06
1988,Краснодарский край,"Краснодар, Центральная",912,2,123970,5,914,18448,0.05
2495,Краснодарский край,"Краснодар, Калининская",907,0,212366,6,907,18448,0.05
550,Краснодарский край,Тимашевская,497,2,77749,5,499,18448,0.03
2584,Краснодарский край,Крымская,2425,29,98401,5,2454,18448,0.13
1097,Краснодарский край,Темрюкская,1043,0,88914,5,1043,18448,0.06
1653,Краснодарский край,"Новороссийск, Приморская",1125,19,62542,5,1144,18448,0.06
1833,Краснодарский край,Туапсинская городская,957,17,47128,4,974,18448,0.05
467,Краснодарский край,Белореченская,370,5,84068,5,375,18448,0.02
1124,Краснодарский край,"Сочи, Лазаревская",544,3,74134,5,547,18448,0.03
1454,Краснодарский край,Выселковская,1107,15,46381,4,1122,18448,0.06
695,Краснодарский край,Новопокровская,621,4,32299,4,625,18448,0.03
1734,Краснодарский край,Усть-Лабинская,1238,22,78493,5,1260,18448,0.07
1851,Краснодарский край,Курганинская,1357,38,68901,5,1395,18448,0.08
508,Краснодарский край,Новокубанская,474,0,63316,5,474,18448,0.03
1268,Краснодарский край,Ейская городская,577,15,72697,5,592,18448,0.03
2976,Краснодарский край,Кущевская,1738,50,50525,5,1788,18448,0.1
1398,Краснодарский край,Староминская,1210,18,30751,4,1228,18448,0.07
2471,Красноярский край,Канская городская,843,33,65783,5,876,5808,0.15
1634,Красноярский край,"Красноярск, Свердловская",552,12,102730,5,564,5808,0.1
375,Красноярский край,Ачинская,123,9,12142,4,132,5808,0.02
1489,Красноярский край,Железногорская городская,674,10,149665,5,684,5808,0.12
1582,Красноярский край,"Красноярск, Центральная",724,26,60694,5,750,5808,0.13
55,Красноярский край,Идринская,36,0,8958,4,36,5808,0.01
1312,Красноярский край,Курагинская,410,17,34676,4,427,5808,0.07
431,Красноярский край,Назаровская,230,6,14304,4,236,5808,0.04
1092,Красноярский край,Шушенская,438,11,26034,4,449,5808,0.08
1652,Красноярский край,Богучанская,319,335,29818,4,654,5808,0.11
175,Красноярский край,Иланская,92,2,16608,4,94,5808,0.02
1446,Красноярский край,Норильская городская,637,21,109141,5,658,5808,0.11
354,Красноярский край,Таймырская Долгано-Ненецкая №2,247,1,3485,3,248,5808,0.04
607,Курганская область,Варгашинская,342,6,14167,4,348,2174,0.16
350,Курганская область,Кетовская,149,0,42472,4,149,2174,0.07
1842,Курганская область,"Курган, Западная",614,10,132571,5,624,2174,0.29
115,Курганская область,Мокроусовская,75,2,8612,4,77,2174,0.04
1023,Курганская область,Шадринская,681,10,20947,4,691,2174,0.32
550,Курганская область,Щучанская,278,7,16610,4,285,2174,0.13
281,Курская область,Золотухинская,145,4,16331,4,149,1640,0.09
554,Курская область,Курская -109,282,2,17559,4,284,1640,0.17
255,Курская область,Поныровская,187,0,8843,4,187,1640,0.11
123,Курская область,Глушковская,110,0,16773,4,110,1640,0.07
1634,Курская область,"Курск, Сеймская",619,12,103288,5,631,1640,0.38
141,Курская область,Пристенская,100,3,11560,4,103,1640,0.06
264,Курская область,Черемисиновская,174,2,7504,4,176,1640,0.11
2405,Ленинградская область,Всеволожская,1148,31,315637,6,1179,4551,0.26
2245,Ленинградская область,Кировская,852,31,226653,6,883,4551,0.19
815,Ленинградская область,Гатчинская 112,478,8,104308,5,486,4551,0.11
1481,Ленинградская область,Лужская,1150,28,59827,5,1178,4551,0.26
1857,Ленинградская область,Гатчинская 113,547,12,58466,5,559,4551,0.12
467,Ленинградская область,Тихвинская,254,12,56274,5,266,4551,0.06
1275,Липецкая область,Елецкая,963,11,21693,4,974,3160,0.31
239,Липецкая область,Лев-Толстовская,150,3,12155,4,153,3160,0.05
357,Липецкая область,Становлянская,290,9,13488,4,299,3160,0.09
264,Липецкая область,Долгоруковская,176,1,13899,4,177,3160,0.06
2205,Липецкая область,"Липецк, Октябрьская №1",732,30,99293,5,762,3160,0.24
901,Липецкая область,Хлевенская,795,0,15658,4,795,3160,0.25
2162,Московская область,Балашихинская городская,1816,51,372068,6,1867,18418,0.1
1328,Московская область,Мытищинская городская,513,10,183098,6,523,18418,0.03
458,Московская область,Дмитровcкая городская,208,0,129334,5,208,18418,0.01
2352,Московская область,Лобненская городская,571,32,72930,5,603,18418,0.03
3119,Московская область,Химкинская городская,700,14,190646,6,714,18418,0.04
932,Московская область,Егорьевская городская,565,12,76862,5,577,18418,0.03
1074,Московская область,Луховицкая городская,488,20,48535,4,508,18418,0.03
1304,Московская область,Клинская городская,482,10,102568,5,492,18418,0.03
1714,Московская область,Красногорская городская,877,13,194268,6,890,18418,0.05
1093,Московская область,Шаховская городская,483,18,18851,4,501,18418,0.03
1339,Московская область,Люберецкая городская,820,14,253893,6,834,18418,0.05
2689,Московская область,Раменская городская,1446,22,81631,5,1468,18418,0.08
705,Московская область,Можайская городская,342,15,55280,5,357,18418,0.02
2322,Московская область,Одинцовская городская,757,34,147882,5,791,18418,0.04
1044,Московская область,Рузская городская,374,15,52134,5,389,18418,0.02
1457,Московская область,Павлово-Посадская городская,966,6,63270,5,972,18418,0.05
1096,Московская область,Электростальская городская,419,17,113288,5,436,18418,0.02
1833,Московская область,Ленинская городская,396,19,145166,5,415,18418,0.02
1787,Московская область,Подольская городская,681,22,265305,6,703,18418,0.04
1987,Московская область,Пушкинская городская,1008,8,165042,6,1016,18418,0.06
1362,Московская область,Сергиево-Посадская городская,486,9,186649,6,495,18418,0.03
1391,Московская область,Протвинская городская,598,50,28144,4,648,18418,0.04
1608,Московская область,Ступинская городская,956,33,86407,5,989,18418,0.05
1235,Московская область,Богородская городская,663,6,169141,6,669,18418,0.04
2268,Московская область,Фрязинская городская,946,28,46717,4,974,18418,0.05
918,Московская область,Электростальская городская (округ 127),356,23,6338,4,379,18418,0.02
1210,Мурманская область,Мончегорская,384,13,33968,4,397,802,0.5
26,Мурманская область,Мурманская,26,0,217833,6,26,802,0.03
1151,Мурманская область,Печенгская,369,10,25186,4,379,802,0.47
1145,Ненецкий автономный округ,Нарьян-Марская,397,8,17621,4,405,405,1.0
909,Нижегородская область,Кстовская,318,6,94238,5,324,5943,0.05
12,Нижегородская область,"Нижний Новгород, Нижегородская",10,2,101500,5,12,5943,0.0
12,Нижегородская область,"Нижний Новгород, Нижегородская",12,0,101500,5,12,5943,0.0
87,Нижегородская область,"Нижний Новгород, Советская",86,1,128180,5,87,5943,0.01
1479,Нижегородская область,Арзамас округ,793,0,76055,5,793,5943,0.13
1745,Нижегородская область,"Нижний Новгород, Ленинская",544,7,102744,5,551,5943,0.09
98,Нижегородская область,Починковская,83,0,43428,4,83,5943,0.01
505,Нижегородская область,Вознесенская,365,8,11180,4,373,5943,0.06
1699,Нижегородская область,"Нижний Новгород, Автозаводская Северная",504,14,105598,5,518,5943,0.09
2296,Нижегородская область,Балахнинская,744,21,58601,5,765,5943,0.13
1709,Нижегородская область,"Дзержинск, Свердловская",550,17,88896,5,567,5943,0.1
965,Нижегородская область,Бор округ,375,6,94258,5,381,5943,0.06
1472,Нижегородская область,Городецкая,620,19,67192,5,639,5943,0.11
441,Нижегородская область,Семеновский округ,315,0,33013,4,315,5943,0.05
1080,Нижегородская область,Шахунья округ,519,4,27611,4,523,5943,0.09
158,Новгородская область,Любытинская,73,1,6893,4,74,1194,0.06
1625,Новгородская область,Новгородская,683,25,48183,4,708,1194,0.59
970,Новгородская область,Хвойнинская,403,9,10643,4,412,1194,0.35
396,Новосибирская область,Куйбышевская,151,9,68035,5,160,5000,0.03
1548,Новосибирская область,"Новосибирск, Калининская",420,10,147745,5,430,5000,0.09
244,Новосибирская область,Татарская,131,3,29076,4,134,5000,0.03
170,Новосибирская область,Болотнинская,100,17,21203,4,117,5000,0.02
1611,Новосибирская область,"Новосибирск, Дзержинская",397,8,119963,5,405,5000,0.08
2182,Новосибирская область,Тогучинская,1125,29,43194,4,1154,5000,0.23
680,Новосибирская область,Бердская городская,280,5,84743,5,285,5000,0.06
1129,Новосибирская область,Карасукская,434,13,34221,4,447,5000,0.09
2051,Новосибирская область,"Новосибирск, Советская",888,10,100073,5,898,5000,0.18
154,Новосибирская область,Барабинская,108,4,32887,4,112,5000,0.02
572,Новосибирская область,Купинская,238,4,22089,4,242,5000,0.05
2459,Новосибирская область,"Новосибирск, Ленинская",605,11,229231,6,616,5000,0.12
930,Омская область,Калачинская,432,18,32879,4,450,2557,0.18
1701,Омская область,"Омск, Центральная",554,10,226365,6,564,2557,0.22
206,Омская область,ТИК по Омскому району,58,5,83534,5,63,2557,0.02
172,Омская область,Одесская,111,2,11706,4,113,2557,0.04
1909,Омская область,ТИК по Ленинскому административному округу г. Омска Омской области,663,24,148849,5,687,2557,0.27
86,Омская область,ТИК по Полтавскому району,53,1,15582,4,54,2557,0.02
351,Омская область,Любинская,183,10,28416,4,193,2557,0.08
158,Омская область,Саргатская,87,7,13309,4,94,2557,0.04
255,Омская область,ТИК по Знаменскому району,154,1,8830,4,155,2557,0.06
284,Омская область,ТИК по Называевскому району,134,1,16703,4,135,2557,0.05
101,Омская область,ТИК по Тюкалинскому району,49,0,18152,4,49,2557,0.02
97,Оренбургская область,Новосергиевская,63,0,26133,4,63,5105,0.01
2221,Оренбургская область,Оренбургская,1673,60,86590,5,1733,5105,0.34
1246,Оренбургская область,Соль-Илецкая городская,364,13,37892,4,377,5105,0.07
110,Оренбургская область,Абдулинская городская,69,1,23191,4,70,5105,0.01
99,Оренбургская область,Бузулукская,61,0,24560,4,61,5105,0.01
291,Оренбургская область,Матвеевская,168,3,9398,4,171,5105,0.03
683,Оренбургская область,Пономаревская,340,16,11099,4,356,5105,0.07
1979,Оренбургская область,Акбулакская,765,39,17942,4,804,5105,0.16
1740,Оренбургская область,Кувандыкская городская,691,15,33840,4,706,5105,0.14
1662,Оренбургская область,"Орск, Ленинская",588,27,49741,4,615,5105,0.12
338,Оренбургская область,Ясненская городская,142,7,15104,4,149,5105,0.03
517,Орловская область,Колпнянская,459,0,11017,4,459,1706,0.27
415,Орловская область,Мценская,311,7,15810,4,318,1706,0.19
2166,Орловская область,"Орел, Северная",741,30,54309,5,771,1706,0.45
198,Орловская область,Сосковская,157,1,4619,3,158,1706,0.09
1274,Пензенская область,Кузнецкая,1093,6,27033,4,1099,4642,0.24
1535,Пензенская область,Никольская,1251,10,40536,4,1261,4642,0.27
403,Пензенская область,Пензенская,336,0,54842,5,336,4642,0.07
437,Пензенская область,Белинская,283,6,19665,4,289,4642,0.06
1421,Пензенская область,Каменская,594,16,155560,6,610,4642,0.13
1889,Пензенская область,"Пенза, Железнодорожная",769,12,86144,5,781,4642,0.17
326,Пензенская область,Тамалинская,259,7,11457,4,266,4642,0.06
384,Пермский край,Оханская,149,5,11774,4,154,4968,0.03
2081,Пермский край,"Пермь, Кировская",658,38,98235,5,696,4968,0.14
1165,Пермский край,Горнозаводская,415,23,18802,4,438,4968,0.09
191,Пермский край,Лысьвенская,91,10,58326,5,101,4968,0.02
2018,Пермский край,Чусовская,751,32,48892,4,783,4968,0.16
511,Пермский край,Октябрьская,278,13,308508,6,291,4968,0.06
2395,Пермский край,"Пермь, Свердловская № 1",729,34,92115,5,763,4968,0.15
1488,Пермский край,Березниковская,527,26,119683,5,553,4968,0.11
895,Пермский край,Косинская,343,11,5326,4,354,4968,0.07
1988,Пермский край,Нытвенская,690,41,34786,4,731,4968,0.15
180,Пермский край,Юсьвинская,102,2,13899,4,104,4968,0.02
33,Приморский край,"Владивосток, Фрунзенская",32,1,47501,4,33,2416,0.01
1788,Приморский край,Надеждинская,487,7,32924,4,494,2416,0.2
228,Приморский край,Уссурийская городская,185,0,145460,5,185,2416,0.08
2061,Приморский край,"Владивосток, Первореченская",564,20,103184,5,584,2416,0.24
143,Приморский край,Спасская,50,3,73151,5,53,2416,0.02
433,Приморский край,Анучинская,196,9,11362,4,205,2416,0.08
255,Приморский край,Кировская,207,3,226653,6,210,2416,0.09
1127,Приморский край,Находкинская городская,340,19,119052,5,359,2416,0.15
932,Приморский край,Пожарская,278,15,22017,4,293,2416,0.12
494,Псковская область,Великолукская городская,392,16,74216,5,408,1543,0.26
292,Псковская область,Новосокольническая,199,3,10733,4,202,1543,0.13
2068,Псковская область,Псковская,685,18,36215,4,703,1543,0.46
525,Псковская область,Себежская,223,7,14087,4,230,1543,0.15
2768,Республика Адыгея (Адыгея),Майкопская городская,1091,21,131966,5,1112,1112,1.0
3021,Республика Алтай,Горно-Алтайская городская,1008,17,43477,4,1025,1091,0.94
167,Республика Алтай,Усть-Коксинская,64,2,12288,4,66,1091,0.06
1244,Республика Башкортостан,Давлекановская,843,25,30080,4,868,14617,0.06
1575,Республика Башкортостан,"Уфа, Кировская",1167,7,126760,5,1174,14617,0.08
80,Республика Башкортостан,Чекмагушевская,77,0,22863,4,77,14617,0.01
88,Республика Башкортостан,Белокатайская,82,0,14197,4,82,14617,0.01
151,Республика Башкортостан,Бураевская,123,11,18143,4,134,14617,0.01
1050,Республика Башкортостан,Кушнаренковская,880,0,22376,4,880,14617,0.06
127,Республика Башкортостан,Салаватская,124,0,19553,4,124,14617,0.01
2392,Республика Башкортостан,Уфимская (4),1787,14,35945,4,1801,14617,0.12
1753,Республика Башкортостан,Иглинская,1326,5,47466,4,1331,14617,0.09
2408,Республика Башкортостан,"Уфа, Октябрьская",1915,7,172430,6,1922,14617,0.13
1138,Республика Башкортостан,Дюртюлинская,792,5,46788,4,797,14617,0.05
850,Республика Башкортостан,Краснокамская,675,9,75132,5,684,14617,0.05
413,Республика Башкортостан,Туймазинская,401,1,94691,5,402,14617,0.03
624,Республика Башкортостан,Абзелиловская,299,0,33937,4,299,14617,0.02
537,Республика Башкортостан,Зианчуринская,510,0,20738,4,510,14617,0.03
113,Республика Башкортостан,Куюргазинская,106,0,17627,4,106,14617,0.01
1972,Республика Башкортостан,Сибайская городская,1524,12,41421,4,1536,14617,0.11
271,Республика Башкортостан,Альшеевская,261,2,31109,4,263,14617,0.02
346,Республика Башкортостан,Бижбулякская,340,0,17771,4,340,14617,0.02
931,Республика Башкортостан,Ишимбайская,815,13,66784,5,828,14617,0.06
1554,Республика Башкортостан,Стерлитамакская городская,444,15,203037,6,459,14617,0.03
515,Республика Бурятия,Джидинская,303,11,17943,4,314,4190,0.07
1109,Республика Бурятия,Иволгинская,359,7,40484,4,366,4190,0.09
3154,Республика Бурятия,Кяхтинская,2670,52,26532,4,2722,4190,0.65
824,Республика Бурятия,Тарбагатайская,540,12,16087,4,552,4190,0.13
265,Республика Бурятия,"Улан-Удэ, Октябрьская",217,19,138837,5,236,4190,0.06
1070,Республика Дагестан,Кизилюртовская городская,1011,0,24992,4,1011,8164,0.12
1752,Республика Дагестан,"Махачкала, Советская",1393,0,91173,5,1393,8164,0.17
1851,Республика Дагестан,Дагогнинская городская,1628,0,22594,4,1628,8164,0.2
2433,Республика Дагестан,Карабудахкентская,2152,0,52072,5,2152,8164,0.26
451,Республика Дагестан,Сергокалинская,412,0,20570,4,412,8164,0.05
426,Республика Дагестан,Хивская,385,0,13710,4,385,8164,0.05
17,Республика Дагестан,Ботлихская,16,0,28596,4,16,8164,0.0
276,Республика Дагестан,Гунибская,182,0,16275,4,182,8164,0.02
496,Республика Дагестан,Курахская,487,0,10257,4,487,8164,0.06
271,Республика Дагестан,Рутульская,229,0,14946,4,229,8164,0.03
165,Республика Дагестан,Хунзахская,138,0,22494,4,138,8164,0.02
139,Республика Дагестан,Чародинская,131,0,8770,4,131,8164,0.02
1604,Республика Ингушетия,Назрановская,1365,3,58682,5,1368,1368,1.0
535,Республика Калмыкия,Сарпинская,182,7,8188,4,189,189,1.0
166,Республика Карелия,Кемская,63,5,12597,4,68,1110,0.06
2334,Республика Карелия,Петрозаводская городская №1,952,24,108274,5,976,1110,0.88
165,Республика Карелия,Пряжинская,65,1,12466,4,66,1110,0.06
2032,Республика Коми,Вуктыльская городская,775,35,10184,4,810,2010,0.4
90,Республика Коми,Прилузская,65,1,16382,4,66,2010,0.03
2392,Республика Коми,Сыктывкарская городская,925,21,148801,5,946,2010,0.47
538,Республика Коми,Усть-Куломская,185,3,21097,4,188,2010,0.09
772,Республика Крым,Бахчисарайская,416,15,72752,5,431,5169,0.08
2043,Республика Крым,Симферопольская - 19,555,16,48414,4,571,5169,0.11
3194,Республика Крым,Керченская городская,1910,61,106485,5,1971,5169,0.38
237,Республика Крым,Ленинская,147,1,245986,6,148,5169,0.03
2137,Республика Крым,Симферопольская - 20,1147,30,49772,4,1177,5169,0.23
1973,Республика Крым,Евпаторийская городская,733,22,87407,5,755,5169,0.15
150,Республика Крым,Сакская,115,1,61840,5,116,5169,0.02
1893,Республика Марий Эл,Волжская городская,745,17,257014,6,762,2533,0.3
2490,Республика Марий Эл,Йошкар-Олинская городская № 1,976,20,104003,5,996,2533,0.39
1303,Республика Марий Эл,Медведевская,601,11,57780,5,612,2533,0.24
295,Республика Марий Эл,Юринская,158,5,6169,4,163,2533,0.06
650,Республика Мордовия,Дубенская,537,0,19540,4,537,1798,0.3
340,Республика Мордовия,Ковылкинская,286,0,29402,4,286,1798,0.16
1625,Республика Мордовия,Октябрьская,730,11,308508,6,741,1798,0.41
322,Республика Мордовия,Рузаевская,217,17,47811,4,234,1798,0.13
941,Республика Саха (Якутия),Алданская,403,11,32959,4,414,1140,0.36
522,Республика Саха (Якутия),Горная,380,1,6927,4,381,1140,0.33
408,Республика Саха (Якутия),Намская,242,8,15754,4,250,1140,0.22
78,Республика Саха (Якутия),Сунтарская,56,0,15880,4,56,1140,0.05
48,Республика Саха (Якутия),Чурапчинская,39,0,14329,4,39,1140,0.03
278,Республика Северная Осетия - Алания,ТИК Алагирского района,235,2,28120,4,237,3200,0.07
2811,Республика Северная Осетия - Алания,ТИК Моздокского района,1575,41,58518,5,1616,3200,0.5
1505,Республика Северная Осетия - Алания,ТИК Пригородного района,1347,0,76509,5,1347,3200,0.42
1976,Республика Татарстан (Татарстан),"Казань, Приволжская",811,28,195525,6,839,13566,0.06
542,Республика Татарстан (Татарстан),Лаишевская,535,0,40152,4,535,13566,0.04
379,Республика Татарстан (Татарстан),Сабинская,367,1,23955,4,368,13566,0.03
219,Республика Татарстан (Татарстан),Атнинская,209,2,9826,4,211,13566,0.02
1025,Республика Татарстан (Татарстан),Высокогорская,927,11,42511,4,938,13566,0.07
1889,Республика Татарстан (Татарстан),"Казань, Кировская",1166,23,92311,5,1189,13566,0.09
424,Республика Татарстан (Татарстан),Тетюшская,418,2,16466,4,420,13566,0.03
190,Республика Татарстан (Татарстан),Заинская,181,1,10144,4,182,13566,0.01
2634,Республика Татарстан (Татарстан),Нижнекамская городская,1441,61,171584,6,1502,13566,0.11
176,Республика Татарстан (Татарстан),Черемшанская,171,0,14144,4,171,13566,0.01
464,Республика Татарстан (Татарстан),Актанышская,460,0,21692,4,460,13566,0.03
2763,Республика Татарстан (Татарстан),"Набережные Челны, Комсомольская",2329,22,111013,5,2351,13566,0.17
375,Республика Татарстан (Татарстан),Азнакаевская,340,1,20516,4,341,13566,0.03
78,Республика Татарстан (Татарстан),Альметьевская городская,78,0,114447,5,78,13566,0.01
752,Республика Татарстан (Татарстан),Лениногорская,706,1,15564,4,707,13566,0.05
2674,Республика Татарстан (Татарстан),"Казань, Авиастроительная",1721,16,89704,5,1737,13566,0.13
2714,Республика Татарстан (Татарстан),"Казань, Советская",1524,13,246285,6,1537,13566,0.11
2643,Республика Тыва,Кызылская городская,1495,17,75080,5,1512,1512,1.0
2098,Республика Хакасия,Абаканская городская,721,17,132218,5,738,1037,0.71
195,Республика Хакасия,Орджоникидзевская,105,6,8925,4,111,1037,0.11
580,Республика Хакасия,Ширинская,182,6,20875,4,188,1037,0.18
427,Ростовская область,Кагальницкая,187,0,22956,4,187,7915,0.02
640,Ростовская область,Сальская,199,0,78075,5,199,7915,0.03
1149,Ростовская область,Азовская городская,488,5,57905,5,493,7915,0.06
2066,Ростовская область,"Ростов-на-Дону, Советская",725,6,134396,5,731,7915,0.09
469,Ростовская область,Неклиновская,170,7,71631,5,177,7915,0.02
1838,Ростовская область,Таганрогская городская (западная),523,14,105617,5,537,7915,0.07
2053,Ростовская область,Новочеркасская городская,652,13,118153,5,665,7915,0.08
1051,Ростовская область,Белокалитвинская,675,0,71822,5,675,7915,0.09
1497,Ростовская область,Каменск-Шахтинская городская,656,12,64117,5,668,7915,0.08
503,Ростовская область,Миллеровская,259,6,48605,4,265,7915,0.03
519,Ростовская область,Чертковская,407,0,24534,4,407,7915,0.05
838,Ростовская область,Красносулинская,594,0,53607,5,594,7915,0.08
2204,Ростовская область,Шахтинская городская,547,5,156229,6,552,7915,0.07
1445,Ростовская область,Волгодонская городская,503,17,117569,5,520,7915,0.07
1526,Ростовская область,Морозовская,610,13,30218,4,623,7915,0.08
1402,Ростовская область,Цимлянская,609,13,25697,4,622,7915,0.08
662,Рязанская область,Кадомская,330,4,6031,4,334,2823,0.12
2534,Рязанская область,"Рязань, Московская",798,18,138159,5,816,2823,0.29
198,Рязанская область,Шацкая,174,0,17319,4,174,2823,0.06
1146,Рязанская область,Захаровская,668,3,7723,4,671,2823,0.24
701,Рязанская область,Рязанская - 157,322,5,17530,4,327,2823,0.12
588,Рязанская область,Скопинская,498,3,20203,4,501,2823,0.18
1818,Самарская область,Волжская - 158,1546,0,39847,4,1546,8257,0.19
1877,Самарская область,"Самара, Куйбышевская",570,16,66395,5,586,8257,0.07
2001,Самарская область,"Тольятти, Автозаводская",688,27,330862,6,715,8257,0.09
447,Самарская область,"Тольятти, Центральная",423,5,119300,5,428,8257,0.05
2741,Самарская область,Красноярская,1048,51,66222,5,1099,8257,0.13
2035,Самарская область,"Самара, Кировская",1243,25,175908,6,1268,8257,0.15
2309,Самарская область,Безенчукская,945,28,29274,4,973,8257,0.12
397,Самарская область,Ставропольская - 161,215,4,10443,4,219,8257,0.03
507,Самарская область,Хворостянская,499,0,10485,4,499,8257,0.06
640,Самарская область,Кинель-Черкасская,306,11,29892,4,317,8257,0.04
1787,Самарская область,"Самара, Промышленная",593,14,205474,6,607,8257,0.07
1181,Саратовская область,Петровская,559,11,94728,5,570,5931,0.1
1824,Саратовская область,"Саратов, Ленинская",876,0,207581,6,876,5931,0.15
998,Саратовская область,Балаковская,379,6,154813,6,385,5931,0.06
451,Саратовская область,Дергачевская,395,0,15400,4,395,5931,0.07
888,Саратовская область,Перелюбская,390,15,11018,4,405,5931,0.07
566,Саратовская область,Аркадакская,410,2,17082,4,412,5931,0.07
178,Саратовская область,Екатериновская,102,0,13347,4,102,5931,0.02
892,Саратовская область,Ртищевская,385,5,39421,4,390,5931,0.07
1343,Саратовская область,Турковская,781,16,8649,4,797,5931,0.13
1291,Саратовская область,Новоузенская,595,6,21583,4,601,5931,0.1
1921,Саратовская область,Энгельсская,991,7,218814,6,998,5931,0.17
1093,Сахалинская область,Долинская,481,15,19904,4,496,1003,0.49
275,Сахалинская область,Охинская,137,3,19482,4,140,1003,0.14
1155,Сахалинская область,Южно-Сахалинская городская,359,8,151057,6,367,1003,0.37
1684,Свердловская область,"Екатеринбург, Верх-Исетская",643,18,182120,6,661,9298,0.07
1748,Свердловская область,"Екатеринбург, Ленинская",810,27,163460,6,837,9298,0.09
2571,Свердловская область,"Екатеринбург, Чкаловская",1033,27,205928,6,1060,9298,0.11
973,Свердловская область,Сысертская,421,13,55056,5,434,9298,0.05
1952,Свердловская область,"Екатеринбург, Кировская",862,20,157940,6,882,9298,0.09
1679,Свердловская область,Режевская,706,30,36297,4,736,9298,0.08
1791,Свердловская область,"Нижний Тагил, Дзержинская",954,34,87254,5,988,9298,0.11
131,Свердловская область,Пригородная,82,6,26183,4,88,9298,0.01
113,Свердловская область,"Екатеринбург, Октябрьская",111,2,111193,5,113,9298,0.01
1957,Свердловская область,Рефтинская поселковая,945,25,12083,4,970,9298,0.1
508,Свердловская область,Туринская,297,7,20242,4,304,9298,0.03
749,Свердловская область,Красноуфимская городская,390,15,29303,4,405,9298,0.04
259,Свердловская область,Первоуральская городская,105,6,115934,5,111,9298,0.01
367,Свердловская область,Гаринская,212,8,2580,3,220,9298,0.02
836,Свердловская область,Нижнетуринская,465,13,20140,4,478,9298,0.05
1989,Свердловская область,Тавдинская,990,21,28351,4,1011,9298,0.11
254,Смоленская область,Дорогобужская,117,5,21587,4,122,1736,0.07
1484,Смоленская область,"Смоленск, Заднепровская",489,12,74580,5,501,1736,0.29
1565,Смоленская область,Десногорская,710,22,23560,4,732,1736,0.42
304,Смоленская область,Рославльская,149,4,54704,5,153,1736,0.09
385,Смоленская область,Шумячская,223,5,8300,4,228,1736,0.13
1250,Ставропольский край,Петровская,976,33,94728,5,1009,7640,0.13
214,Ставропольский край,Шпаковская,184,0,99515,5,184,7640,0.02
1980,Ставропольский край,Невинномысская городская,1476,5,83349,5,1481,7640,0.19
1659,Ставропольский край,Шпаковская,1413,0,99515,5,1413,7640,0.18
1688,Ставропольский край,Минераловодская,1357,10,95085,5,1367,7640,0.18
2261,Ставропольский край,Апанасенковская,1058,91,22118,4,1149,7640,0.15
1630,Ставропольский край,Курская,987,50,33826,4,1037,7640,0.14
2200,Тамбовская область,Котовская городская,1391,3,23943,4,1394,4812,0.29
1300,Тамбовская область,Моршанская городская,828,8,28874,4,836,4812,0.17
2319,Тамбовская область,"Тамбов, Советская",948,27,74992,5,975,4812,0.2
1569,Тамбовская область,Знаменская,653,21,16956,4,674,4812,0.14
610,Тамбовская область,Рассказовская,412,0,14938,4,412,4812,0.09
638,Тамбовская область,Тамбовская_178,519,2,21801,4,521,4812,0.11
1366,Тверская область,Калининская-179,533,16,30361,4,549,3911,0.14
1687,Тверская область,Конаковская,538,19,67947,5,557,3911,0.14
2050,Тверская область,"Тверь, Московская",788,22,97796,5,810,3911,0.21
1123,Тверская область,Бологовская,450,15,27991,4,465,3911,0.12
1538,Тверская область,Калининская-180,503,12,21674,4,515,3911,0.13
278,Тверская область,Пеновская,219,5,5089,4,224,3911,0.06
2391,Тверская область,"Тверь, Заволжская",772,19,116077,5,791,3911,0.2
184,Томская область,Асиновская,74,2,26901,4,76,919,0.08
1330,Томская область,"Томск, Ленинская",327,12,84455,5,339,919,0.37
355,Томская область,Каргасокская,229,2,17075,4,231,919,0.25
435,Томская область,Молчановская,215,3,10430,4,218,919,0.24
103,Томская область,Томская (182),55,0,60857,5,55,919,0.06
1159,Тульская область,Богородицкая,734,10,38436,4,744,4169,0.18
1275,Тульская область,Киреевская,787,9,55226,5,796,4169,0.19
227,Тульская область,Тепло-Огаревская,146,3,9754,4,149,4169,0.04
233,Тульская область,Чернская,176,0,14490,4,176,4169,0.04
579,Тульская область,Веневская,317,5,23692,4,322,4169,0.08
1905,Тульская область,Новомосковская,899,23,206412,6,922,4169,0.22
1537,Тульская область,Узловская,1052,8,62614,5,1060,4169,0.25
111,Тюменская область,Викуловская,63,5,11638,4,68,5944,0.01
408,Тюменская область,Тобольская,334,3,15649,4,337,5944,0.06
1657,Тюменская область,"Тюмень, Центральная",767,19,145962,5,786,5944,0.13
1881,Тюменская область,Голышмановская,1637,0,18576,4,1637,5944,0.28
686,Тюменская область,Сладковская,655,0,8717,4,655,5944,0.11
3548,Тюменская область,"Тюмень, Калининская",2406,55,160701,6,2461,5944,0.41
854,Удмуртская Республика,Балезинская,446,19,24829,4,465,4381,0.11
2322,Удмуртская Республика,Глазовская городская,1066,42,66759,5,1108,4381,0.25
2497,Удмуртская Республика,"Ижевск, Индустриальная",883,13,92570,5,896,4381,0.2
155,Удмуртская Республика,Юкаменская,112,1,7529,4,113,4381,0.03
1113,Удмуртская Республика,Завьяловская 34,518,29,26526,4,547,4381,0.12
2163,Удмуртская Республика,"Ижевск, Первомайская",736,16,96349,5,752,4381,0.17
266,Удмуртская Республика,Можгинская,159,2,19513,4,161,4381,0.04
632,Удмуртская Республика,Увинская,329,10,29174,4,339,4381,0.08
1202,Ульяновская область,Сенгилеевская,564,10,17054,4,574,1944,0.3
1970,Ульяновская область,"Ульяновск, Ленинская",681,8,95761,5,689,1944,0.35
107,Ульяновская область,Вешкаймская,72,3,13693,4,75,1944,0.04
336,Ульяновская область,Николаевская,226,1,64450,5,227,1944,0.12
86,Ульяновская область,Сурская,77,0,12330,4,77,1944,0.04
601,Ульяновская область,Ульяновская,296,6,32278,4,302,1944,0.16
504,Хабаровский край,Комсомольская,258,16,51088,5,274,2339,0.12
458,Хабаровский край,Ульчская,238,24,13509,4,262,2339,0.11
1659,Хабаровский край,Хабаровская (ОИК 69),612,31,31115,4,643,2339,0.27
2414,Хабаровский край,Комсомольская городская,849,39,178774,6,888,2339,0.38
628,Хабаровский край,Хабаровская (ОИК 70),267,5,30796,4,272,2339,0.12
1578,Ханты-Мансийский автономный округ - Югра,Нефтеюганская городская,924,37,78611,5,961,2706,0.36
943,Ханты-Мансийский автономный округ - Югра,Сургутская в части №222,466,42,89473,5,508,2706,0.19
292,Ханты-Мансийский автономный округ - Югра,Нижневартовская,247,15,18530,4,262,2706,0.1
2422,Ханты-Мансийский автономный округ - Югра,Сургутская городская,946,29,287508,6,975,2706,0.36
826,Челябинская область,Сосновская,413,21,101674,5,434,8222,0.05
1137,Челябинская область,Уйская,509,13,16686,4,522,8222,0.06
531,Челябинская область,"Челябинск, Калининская",485,46,159648,6,531,8222,0.06
1088,Челябинская область,Верхнеуфалейская городская,544,8,24465,4,552,8222,0.07
262,Челябинская область,Кыштымская городская,158,3,29254,4,161,8222,0.02
2106,Челябинская область,"Челябинск, Металлургическая",1174,27,95665,5,1201,8222,0.15
1119,Челябинская область,Копейская городская,458,19,109523,5,477,8222,0.06
98,Челябинская область,Увельская,83,2,22396,4,85,8222,0.01
200,Челябинская область,Агаповская,161,3,24743,4,164,8222,0.02
1315,Челябинская область,Карталинская,524,12,32748,4,536,8222,0.07
2707,Челябинская область,"Магнитогорск, Орджоникидзевская",1361,39,154133,6,1400,8222,0.17
109,Челябинская область,Чесменская,76,0,13374,4,76,8222,0.01
2343,Челябинская область,Златоустовская городская,1051,27,118599,5,1078,8222,0.13
1740,Челябинская область,Миасская городская,630,14,132547,5,644,8222,0.08
1005,Челябинская область,Чебаркульская городская,353,8,33841,4,361,8222,0.04
2075,Чеченская Республика,"Грозный, Висаитовская",1926,0,44534,4,1926,4757,0.4
2786,Чеченская Республика,Наурская,2579,0,33108,4,2579,4757,0.54
258,Чеченская Республика,Шатойская,252,0,12760,4,252,4757,0.05
1244,Чувашская Республика - Чувашия,Канашская городская,589,29,34000,4,618,4508,0.14
2357,Чувашская Республика - Чувашия,Новочебоксарская городская,1060,19,96979,5,1079,4508,0.24
1390,Чувашская Республика - Чувашия,"Чебоксары, Калининская",655,11,128769,5,666,4508,0.15
1045,Чувашская Республика - Чувашия,Алатырская,892,9,11892,4,901,4508,0.2
394,Чувашская Республика - Чувашия,Красночетайская,319,8,11003,4,327,4508,0.07
1443,Чувашская Республика - Чувашия,"Чебоксары, Ленинская",597,19,104739,5,616,4508,0.14
456,Чувашская Республика - Чувашия,Ядринская,297,4,21282,4,301,4508,0.07
1274,Ямало-Ненецкий автономный округ,Новоуренгойская городская,912,17,66076,5,929,929,1.0
416,Ярославская область,Даниловская,214,2,30286,4,216,4333,0.05
1694,Ярославская область,"Ярославль, Дзержинская",541,18,117074,5,559,4333,0.13
1911,Ярославская область,"Ярославль, Фрунзенская",591,5,94331,5,596,4333,0.14
2621,Ярославская область,Переславль-Залесская городская,1674,33,30899,4,1707,4333,0.39
1924,Ярославская область,"Рыбинск, Пролетарская",856,9,70228,5,865,4333,0.2
1084,Ярославская область,Ярославская - 195,381,9,26094,4,390,4333,0.09
1661,город Москва,район Богородское,526,4,50712,5,530,12289,0.04
1241,город Москва,район Крылатское,470,4,41633,4,474,12289,0.04
1938,город Москва,район Фили-Давыдково,652,11,49595,4,663,12289,0.05
1844,город Москва,район Восточное Дегунино,607,14,43165,4,621,12289,0.05
1729,город Москва,район Кузьминки,681,8,60647,5,689,12289,0.06
1738,город Москва,Алтуфьевский район,504,22,24690,4,526,12289,0.04
1929,город Москва,район Северный,547,10,20582,4,557,12289,0.05
8,город Москва,район Москворечье-Сабурово,8,0,32683,4,8,12289,0.0
2237,город Москва,Новомосковская,914,11,206412,6,925,12289,0.08
1615,город Москва,район Очаково-Матвеевское,530,12,58007,5,542,12289,0.04
1572,город Москва,район Братеево,603,5,42250,4,608,12289,0.05
1695,город Москва,Нижегородский район,525,34,19534,4,559,12289,0.05
1699,город Москва,район Новокосино,505,10,44762,4,515,12289,0.04
1703,город Москва,район Ивановское,519,7,57942,5,526,12289,0.04
1372,город Москва,район Соколиная гора,505,6,41709,4,511,12289,0.04
1412,город Москва,район Хорошево-Мневники,383,2,80810,5,385,12289,0.03
1775,город Москва,район Крюково,603,12,53637,5,615,12289,0.05
1416,город Москва,район Старое Крюково,522,6,16699,4,528,12289,0.04
2251,город Москва,Тверской район,787,15,41601,4,802,12289,0.07
1620,город Москва,Ломоносовский район,525,6,39928,4,531,12289,0.04
2124,город Москва,район Теплый Стан,611,12,61909,5,623,12289,0.05
1915,город Москва,район Южное Бутово,543,8,103354,5,551,12289,0.04
1307,город Санкт-Петербург,Территориальная избирательная комиссия №30,469,7,54633,5,476,8703,0.05
547,город Санкт-Петербург,Территориальная избирательная комиссия №64,211,2,48910,4,213,8703,0.02
1394,город Санкт-Петербург,Территориальная избирательная комиссия №55,589,13,28491,4,602,8703,0.07
2134,город Санкт-Петербург,Территориальная избирательная комиссия №17,744,24,50310,5,768,8703,0.09
1455,город Санкт-Петербург,Территориальная избирательная комиссия №37,453,15,48364,4,468,8703,0.05
1264,город Санкт-Петербург,Территориальная избирательная комиссия №4,362,16,62528,5,378,8703,0.04
2600,город Санкт-Петербург,Территориальная избирательная комиссия №12,745,6,131500,5,751,8703,0.09
1256,город Санкт-Петербург,Территориальная избирательная комиссия №57,420,4,85658,5,424,8703,0.05
2202,город Санкт-Петербург,Территориальная избирательная комиссия №2,916,16,43738,4,932,8703,0.11
2419,город Санкт-Петербург,Территориальная избирательная комиссия №21,911,8,113570,5,919,8703,0.11
2987,город Санкт-Петербург,Территориальная избирательная комиссия №62,946,33,41072,4,979,8703,0.11
2753,город Санкт-Петербург,Территориальная избирательная комиссия №27,831,17,90854,5,848,8703,0.1
2540,город Санкт-Петербург,Территориальная избирательная комиссия №59,933,12,70213,5,945,8703,0.11
1806,город Севастополь,Ленинская,685,16,245986,6,701,701,1.0
